#################################
#           #   #     #       # S
########### # # # ##### ##### # #
#           # # #   #       #   #
# ### ####### # ### # ##### #####
# # # #     # # #   # #         #
### # # # # # # # # # # ####### #
#   # # # # # #   # # # #   #   #
### # # # ### # ### # # # ### ###
#   #   # #   #   # # # #   #   #
# ####### # ##### # # # ### ### #
E #     # # #     # # #   #     #
# # ### # ### ##### # ### # #####
#   #   #         # #   # # #   #
### # ########### ##### # ### # #
#   #     #     #     # #     # #
# ### ### ##### ##### ######### #
# #   #   #   # #     #     #   #
# # ### ### # # # ##### ### # ###
# #   #   # #   #         #     #
# ### ### # ################### #
# # #   # # #     #         #   #
# # ### # # # # ### ####### # ###
#     # #   # #     #     #   # #
####### ##### ######### # ##### #
#     # #     #         # #   # #
# ### # # ##### ######### # # # #
# #   # #       # #     #   # # #
# # ### ######### # ### ##### # #
# #       #         # #     #   #
# ####### # # ####### ### # # ###
#       #   #         #   #     #
#################################