#####S###########################
#     #   #   #   #   #   #     #
# ### # # # # # # ### # # # ### #
#   # # #   #   #     # # # #   #
### # ############# ##### ### ###
#   # #   #         #   #   #   #
# ### # ### ######### # # # # # #
# # #   #   #   #   # #   #   # #
# # # ### # ### # # # ######### #
#   #   # #     # #   #     #   #
####### # ### ### ### ##### # ###
#       #   #   #   #   #   #   #
# ##### ### ####### ### # ##### #
#   #   # # #       #   #   #   #
### # ### # # # ##### ##### #####
#   #   # # # #   #             #
# ##### # # # ### # ########### #
#   #   # # # #   # #   #   #   #
### # ### # ### ##### # # ### ###
#   #   # #     #     # #   #   #
# ### # # ####### ##### # # # # #
#   # #   #   # #   #   # # # # #
# # ####### # # # # # ##### # # #
# #       # #   # # #       # # #
######### # # ##### ### ##### # #
#   #   #   # #     # #   #   # #
# # # # ### ### # ### ### # ### #
# #   #   #     #   #   # # #   #
# ####### ######### # # # # #####
#       #     #     # #   #     #
##### # ##### # ##### ####### # #
#     #     #       #         # #
###############################E#